...###
..##.#.####
.##..###..#
##........#
#......#..#
###..###.@#