#####....###
#..........#
....##.....#
....#@...#..
............
#.....#....#
###......###